nbmonstre = 3
monstre : x=950 y=70 type 3
monstre : x=448 y=64 type 1
monstre : x=224 y=224 type 1
longueur = 19, largeur = 10
lv ={0,2,2,2,2,2,2,2,2,2,2,2,2,2,2,2,2,2,0,
     1,7,7,7,7,7,7,7,7,7,7,7,1,7,7,7,7,7,1,
     1,7,7,7,7,7,7,7,7,7,7,7,1,7,7,7,7,7,1
     1,7,7,7,7,7,7,7,7,7,7,7,0,7,7,7,7,7,1,
     1,7,7,7,7,7,7,7,7,7,7,7,7,7,7,7,7,7,1,
     1,7,7,7,7,7,7,7,7,7,7,7,0,7,7,7,7,7,1,
     1,7,7,7,7,7,7,7,7,7,7,7,1,7,7,7,7,7,1,
     1,7,7,7,7,7,7,7,7,7,7,7,1,7,7,7,7,7,1,
     1,7,7,7,7,7,7,7,7,7,7,7,1,7,7,7,7,7,1,
     0,2,2,2,2,2,2,2,2,2,2,2,2,2,2,2,2,2,0}
