nbmonstre = 3
monstre : x=1088 y=128 type 7
monstre : x=448 y=256 type 1
monstre : x=224 y=224 type 1
longueur = 19, largeur = 10
lv ={0,2,2,2,2,2,2,2,2,2,2,2,2,2,2,2,2,2,0,
     1,7,7,7,7,7,7,7,7,7,7,7,1,7,7,7,7,7,1,
     1,7,0,2,2,2,2,2,2,2,0,7,1,7,7,7,7,7,1
     1,7,1,7,7,7,7,7,7,7,1,7,1,7,2,2,2,2,0,
     1,7,1,7,7,7,7,7,7,7,1,7,1,7,7,7,7,7,1,
     1,7,1,7,7,7,7,7,7,7,1,7,0,2,2,2,2,7,1,
     1,7,1,7,7,7,7,7,7,7,1,7,1,7,7,7,7,7,1,
     1,7,0,7,7,7,7,7,7,7,1,7,1,7,2,2,2,2,0,
     1,7,7,7,7,7,7,7,7,7,1,7,7,7,7,7,7,7,1,
     0,2,2,2,2,2,2,2,2,2,2,2,2,2,2,2,2,2,0}
