nbmonstre = 5
lv ={1,1,1,1,0,0,0,0,1,1,1,1,0,0,0,0,
     0,0,0,0,1,1,1,1,0,0,0,0,1,1,1,1,
     1,1,1,1,0,0,0,0,1,1,1,1,0,0,0,0,
     0,0,0,0,1,1,1,1,0,0,0,0,1,1,1,1,
     1,1,1,1,0,0,0,0,1,1,1,1,0,0,0,0,
     0,0,0,0,1,1,1,1,0,0,0,0,1,1,1,1,
     1,1,1,1,0,0,0,0,1,1,1,1,0,0,0,0
     0,0,0,0,1,1,1,1,0,0,0,0,1,1,1,1,}
