nbmonstre = 4
monstre : x=128 y=128 type=7
monstre : x=128 y=448 type=7
monstre : x=1024 y=128 type=7
monstre : x=1024 y=448 type=7
longueur = 19, largeur = 10
lv ={0,2,2,2,2,2,2,2,2,2,2,2,2,2,2,2,2,2,0,
     1,15,15,15,15,15,15,15,15,0,15,15,15,15,15,15,15,15,1,
     1,15,0,0,2,2,2,2,2,2,2,2,0,15,0,0,0,15,1
     1,15,15,15,0,15,15,15,0,15,0,15,0,15,15,15,0,15,0,
     1,15,0,15,0,15,0,15,0,15,15,15,0,15,0,15,1,15,1,
     1,15,0,15,0,15,0,15,15,15,0,15,0,15,0,15,1,15,1,
     1,15,0,15,15,15,0,15,0,15,0,15,15,15,0,15,0,15,1,
     1,15,0,0,2,2,2,2,2,2,2,2,2,2,2,0,0,15,0,
     1,15,15,15,15,15,15,15,15,0,15,15,15,15,15,15,15,15,1,
     0,2,2,2,2,2,2,2,2,2,2,2,2,2,2,2,2,2,0}
