nbmonstre = 6
monstre : x=128 y=128 type=1
monstre : x=128 y=512 type=2
monstre : x=128 y=320 type=2
monstre : x=1088 y=320 type=2
monstre : x=1088 y=128 type=2
monstre : x=1088 y=512 type=1
longueur = 19, largeur = 10
lv ={0,2,2,2,2,2,0,2,2,2,2,2,0,2,2,2,2,2,0,
     1,7,7,7,7,7,1,7,7,7,7,7,1,7,7,7,7,7,1,
     1,7,7,7,7,7,1,7,7,7,7,7,1,7,7,7,7,7,1
     0,2,0,7,0,2,0,7,7,7,7,7,0,7,0,2,2,2,0,
     1,7,7,7,7,7,7,7,7,7,7,7,7,7,7,7,7,7,1,
     1,7,7,7,7,7,7,7,7,7,7,7,7,7,7,7,7,7,1,
     0,2,2,2,0,7,0,7,7,7,7,7,0,2,0,7,0,2,0,
     1,7,7,7,7,7,1,7,7,7,7,7,1,7,7,7,7,7,1,
     1,7,7,7,7,7,1,7,7,7,7,7,1,7,7,7,7,7,1,
     0,2,2,2,2,2,0,2,2,2,2,2,0,2,2,2,2,2,0}
