nbmonstre = 5
monstre : x=950 y=70
monstre : x=448 y=64
monstre : x=224 y=224
monstre : x=112 y=70
monstre : x=112 y=555
longueur = 19, largeur = 10
lv ={0,2,2,2,2,2,2,2,2,2,2,2,2,2,2,2,2,2,0,
     1,7,7,7,7,7,7,7,7,7,7,7,7,7,7,7,7,7,1,
     1,7,7,7,7,7,7,7,7,7,7,7,7,7,7,7,7,7,1
     1,7,7,7,7,7,7,7,7,7,7,7,7,7,7,7,7,7,1,
     1,7,7,7,7,7,7,7,7,7,7,7,7,7,7,7,7,7,1,
     1,7,7,7,7,7,7,7,7,7,7,7,7,7,7,7,7,7,1,
     1,7,7,7,7,7,7,7,7,7,7,7,7,7,7,7,7,7,1,
     1,7,7,7,7,7,7,7,7,7,7,7,7,7,7,7,7,7,1,
     1,7,7,7,7,7,7,7,7,7,7,7,7,7,7,7,7,7,1,
     0,2,2,2,2,2,2,2,2,2,2,2,2,2,2,2,2,2,0}

