nbmonstre = 6
monstre : x=128 y=128 type=5
monstre : x=128 y=512 type=7
monstre : x=544 y=512 type=5
monstre : x=1088 y=256 type=5
monstre : x=1088 y=128 type=7
monstre : x=1088 y=512 type=5
longueur = 19, largeur = 10
lv ={0,2,2,2,2,2,2,2,2,2,2,2,2,2,2,2,2,2,0,
     1,7,7,7,7,7,7,7,7,7,7,7,7,7,7,7,7,7,1,
     1,7,0,7,0,7,0,7,0,7,0,7,0,7,0,7,0,7,1
     1,7,7,7,7,7,7,7,7,7,7,7,7,7,7,7,7,7,1,
     1,7,0,7,0,7,0,7,0,7,0,7,0,7,0,7,0,7,1,
     1,7,0,7,0,7,0,7,0,7,0,7,0,7,0,7,0,7,1,
     1,7,7,7,7,7,7,7,7,7,7,7,7,7,7,7,7,7,1,
     1,7,0,7,0,7,0,7,0,7,0,7,0,7,0,7,0,7,1
     1,7,7,7,7,7,7,7,7,7,7,7,7,7,7,7,7,7,1,
     0,2,2,2,2,2,2,2,2,2,2,2,2,2,2,2,2,2,0}
