nbmonstre = 3
monstre : x=1088 y=128 type 7
monstre : x=448 y=256 type 3
monstre : x=224 y=224 type 3
longueur = 19, largeur = 10
lv ={0,2,2,2,2,2,2,2,2,2,2,2,2,2,2,2,2,2,0,
     1,6,6,6,6,6,6,6,6,6,6,6,1,6,6,6,6,6,1,
     1,6,0,2,2,2,2,2,2,6,0,6,1,6,6,6,6,6,1
     1,6,1,6,6,6,6,6,6,6,1,6,1,6,0,2,2,2,0,
     1,6,1,6,6,6,6,6,6,6,1,6,1,6,6,6,6,6,1,
     1,6,1,6,6,6,6,6,6,6,1,6,0,2,2,2,0,6,1,
     1,6,1,6,6,6,6,6,6,6,1,6,1,6,6,6,6,6,1,
     1,6,0,6,6,6,6,6,6,6,1,6,1,6,0,2,2,2,0,
     1,6,6,6,6,6,6,6,6,6,1,6,6,6,6,6,6,6,1,
     0,2,2,2,2,2,2,2,2,2,2,2,2,2,2,2,2,2,0}
