nbmonstre = 4
monstre : x=128 y=128 type=5
monstre : x=128 y=448 type=7
monstre : x=1024 y=128 type=7
monstre : x=1024 y=448 type=5
longueur = 19, largeur = 10
lv ={0,2,2,2,2,2,2,2,2,2,2,2,2,2,2,2,2,2,0,
     1,7,7,7,7,7,7,7,7,7,7,7,7,7,7,7,7,7,1,
     1,7,0,0,2,2,2,2,2,2,2,2,0,7,0,0,0,7,1
     1,7,0,7,0,7,7,7,7,7,7,7,0,7,7,7,0,7,0,
     1,7,0,7,0,7,7,7,0,7,7,7,0,0,0,7,0,7,1,
     1,7,7,7,0,7,7,7,0,7,7,7,7,7,0,7,7,7,1,
     1,7,0,7,7,7,7,7,0,7,7,7,7,7,7,7,0,7,1,
     1,7,0,0,2,2,2,2,2,2,2,2,2,2,2,0,0,7,0,
     1,7,7,7,7,7,7,7,7,7,7,7,7,7,7,7,7,7,1,
     0,2,2,2,2,2,2,2,2,2,2,2,2,2,2,2,2,2,0}
